11111111111111111111
10C000000010000000E1
1P00001C000000000001
10000110000000000001
100001C0000000000001
11111111111111111111
