11111111111
10C000000E1
1P00000C001
10000110001
100001C0001
11111111111
