11111111111111111111
10C10000001000000001
1000001C000000000001
11100110000000000001
1P0001C00000000000E1
11111111111111111111
